TIdAntiFreeze=AntiFreeze
TIdAntiFreezeBase=AntiFreezeBase
TIdAttachment=Attachment
TIdAttachmentClass=AttachmentClass
TIdAttachmentFile=AttachmentFile
TIdAttachmentMemory=AttachmentMemory
TIdAuthenticationSchemes=AuthenticationSchemes
TIdAuthSchemeSet=AuthSchemeSet
TIdAuthWhatsNext=AuthWhatsNext
TIdAuthentication=Authentication
TIdAuthenticationClass=AuthenticationClass
TIdBasicAuthentication=BasicAuth
TIdDigestAuthentication=DigestAuthentication
TIdAuthenticationItem=AuthenticationItem
TIdAuthenticationCollection=AuthenticationCollection
TIdAuthenticationManager=AuthenticationManager
TIdNTLMAuthentication=NTLMAuthentication
TIdSSPINTLMAuthentication=SSPINTLMAuthentication
TIdInitializerComponent=InitializerComponent
TIdBaseComponent=BaseComponent
TIdBlockCipherIntercept=BlockCipherIntercept
TIdBuffer=Buffer
TIdChargenServer=ChargenServer
TIdChargenUDPServer=ChargenUDPServer
TIdCharSet=CharSet
TIdCmdTCPClient=CmdTCPClient
TIdCmdTCPClientListeningThread=CmdTCPClientListeningThread
TIdCmdTCPServer=CmdTCPServer
TIdEncoder=Encoder
TIdDecoder=Decoder
TIdDecoderClass=DecoderClass
TIdDecoder00E=Decoder00E
TIdEncoder00E=Encoder00E
TIdDecodeTable=DecodeTable
TIdEncoder3to4=Encoder3to4
TIdEncoder3to4Class=Encoder3to4Class
TIdDecoder4to3=Decoder4to3
TIdEncoderBinHex4=EncoderBinHex4
TIdDecoderBinHex4=DecoderBinHex4
TIdEncoderMIME=EncoderMIME
TIdDecoderMIME=DecoderMIME
TIdDecoderQuotedPrintable=DecoderQuotedPrintable
TIdEncoderQuotedPrintable=EncoderQuotedPrintable
TIdDecoderUUE=DecoderUUE
TIdEncoderUUE=EncoderUUE
TIdDecoderXXE=DecoderXXE
TIdEncoderXXE=EncoderXXE
TIdCommandHandlers=CommandHandlerList
TIdCommandHandler=CommandHandler
TIdCommand=CommandItem
TIdCommandHandlerClass=CommandHandlerClass
TIdStatus=Status
TIdComponent=Component
TIdCompressionIntercept=CompressionIntercept
TIdServerCompressionIntercept=ServerCompressionIntercept
TIdCompressorBorZLib=CompressorBorZLib
TIdCompressorZLibEx=CompressorZLibEx
TIdConnectThroughHttpProxy=ConnectThroughHttpProxy
TIdObjectList=ObjectList
TIdBubbleSortStringList=BubbleSortStringList
TIdContext=Context
TIdContextClass=ContextClass
TIdCookieVersion=CookieVersion
TIdNetscapeCookie=NetscapeCookie
TIdCookieList=CookieList
TIdCookieRFC2109=CookieRFC2109
TIdCookieRFC2965=CookieRFC2965
TIdServerCookie=ServerCookie
TIdCookieAccess=CookieAccess
TIdCookies=Cookies
TIdServerCookies=ServerCookies
TIdCookieManager=CookieJar
TIdPropEdBinding=PropEdBinding
TIdHTTPSession=HTTPSession
TIdHTTPCustomSessionList=HTTPCustomSessionList
TIdHTTPRequestInfo=HTTPRequestInfo
TIdHTTPResponseInfo=HTTPResponseInfo
TIdCustomHTTPServer=CustomHTTPServer
TIdHTTPDefaultSessionList=HTTPDefaultSessionList
TIdCustomTransparentProxyClass=CustomTransparentProxyClass
TIdCustomTransparentProxy=CustomTransparentProxy
TIdDateTimeStamp=DateTimeStamp
TIdDayTime=DayTime
TIdDayTimeServer=DayTimeServer
TIdDayTimeUDP=DayTimeUDP
TIdDayTimeUDPServer=DayTimeUDPServer
TIdDICTServer=DICTServer
TIdDISCARDServer=DISCARDServer
TIdDiscardUDPServer=DiscardUDPServer
TIdDNSResolver=DNSResolver
TIdDomainExpireCheckThread=DomainExpireCheckThread
TIdDNSMap=DNSMap
TIdDNS_UDPServer=DNS_UDPServer
TIdDomainNameServerMapping=DomainNameServerMapping
TIdTextModeResourceRecord=TextModeResourceRecord
TIdTextModeRRs=TextModeRRs
TIdRR_CName=RR_CName
TIdRR_HINFO=RR_HINFO
TIdRR_MB=RR_MB
TIdRR_MG=RR_MG
TIdRR_MINFO=RR_MINFO
TIdRR_MR=RR_MR
TIdRR_MX=RR_MX
TIdRR_NS=RR_NS
TIdRR_PTR=RR_PTR
TIdRR_SOA=RR_SOA
TIdRR_A=RR_A
TIdRR_AAAA=RR_AAAA
TIdRR_WKS=RR_WKS
TIdRR_TXT=RR_TXT
TIdMWayTreeNodeClass=MWayTreeNodeClass
TIdMWayTreeNode=MWayTreeNode
TIdDNTreeNode=DNTreeNode
TIdDNS_TCPServer=DNS_TCPServer
TIdDNSServer=DNSServer
TIdBaseComponentEditor=BaseComponentEditor
TIdPropEdBindingEntry=PropEdBindingEntry
TIdPropEdSASL=PropEdSASL
TIdEcho=Echo
TIdECHOServer=ECHOServer
TIdEchoUDP=EchoUDP
TIdEchoUDPServer=EchoUDPServer
TIdEMailAddressItem=EMailAddressItem
TIdEMailAddressList=EMailAddressList
TIdUseTLS=UseTLS
TIdExplicitTLSServer=ExplicitTLSServer
TIdExplicitTLSClient=ExplicitTLSClient
TIdFinger=Finger
TIdFingerServer=FingerServer
TIdFtpProxyType=FtpProxyType
TIdFTPClientIdentifier=FTPClientIdentifier
TIdFtpProxySettings=FtpProxySettings
TIdFTPTZInfo=FTPTZInfo
TIdFTP=FTP
TIdFTPBaseFileSystem=FTPBaseFileSystem
TIdFTPTransferType=FTPTransferType
TIdFTPDataStructure=FTPDataStructure
TIdFTPTransferMode=FTPTransferMode
TIdFTPDataPortSecurity=FTPDataPortSecurity
TIdVSEPQDisposition=VSEPQDisposition
TIdDirItemType=DirItemType
TIdJESJobStatus=JESJobStatus
TIdFTPListItems=FTPListItems
TIdFTPListItem=FTPListItem
TIdFTPFactOutput=FTPFactOutput
TIdFTPFactOutputs=FTPFactOutputs
TIdDirOutputFormat=DirOutputFormat
TIdFTPListOutput=FTPListOutput
TIdFTPLPAS400=FTPLPAS400
TIdFTPListCapability=FTPListCapability
TIdFTPListCapabilities=FTPListCapabilities
TIdFTPListBase=FTPListBase
TIdFTPListParseClass=FTPListParseClass
TIdFTPRegParseList=FTPRegParseList
TIdFTPListBaseHeader=FTPListBaseHeader
TIdFTPLPNList=FTPLPNList
TIdFTPLPMList=FTPLPMList
TIdFTPLPGOS7=FTPLPGOS7
TIdFTPLPGOS8=FTPLPGOS8
TIdFTPLPCiscoIOS=FTPLPCiscoIOS
TIdFTPLPDistinctTCPIP=FTPLPDistinctTCPIP
TIdFTPLPEPLF=FTPLPEPLF
TIdFTPLPHellSoft=FTPLPHellSoft
TIdFTPLPKA9Q=FTPLPKA9Q
TIdFTPLPMicrowareOS9=FTPLPMicrowareOS9
TIdFTPLPMPiXBase=FTPLPMPiXBase
TIdFTPLPMPiX=FTPLPMPiX
TIdFTPLPMPiXWithPOSIX=FTPLPMPiXWithPOSIX
TIdFTPLPMusic=FTPLPMusic
TIdFTPLPMVS=FTPLPMVS
TIdFTPLPMVSPartitionedDataSet=FTPLPMVSPartitionedDataSet
TIdFTPLPMVSJESInterface1=FTPLPMVSJESInterface1
TIdFTPLPMVSJESInterface2=FTPLPMVSJESInterface2
TIdFTPLPNCSAforDOS=FTPLPNCSAforDOS
TIdFTPLPNovellNetware=FTPLPNovellNetware
TIdFTPLPNetwarePSUDos=FTPLPNetwarePSUDos
TIdFTPLPNetwarePSUNFS=FTPLPNetwarePSUNFS
TIdFTPLPOS2=FTPLPOS2
TIdFTPLPSterCommExpOS390=FTPLPSterCommExpOS390
TIdFTPLPSterCommEntUx=FTPLPSterCommEntUx
TIdFTPLPSterCommEntUxNS=FTPLPSterCommEntUxNS
TIdFTPLPSterCommEntUxRoot=FTPLPSterCommEntUxRoot
TIdFTPLPTOPS20=FTPLPTOPS20
TIdFTPLPUnix=FTPLPUnix
TIdFTPLPUnitree=FTPLPUnitree
TIdFTPLPVMCMS=FTPLPVMCMS
TIdFTPLPVMBFS=FTPLPVMBFS
TIdFTPLVirtualReader=FTPLVirtualReader
TIdFTPLPVMS=FTPLPVMS
TIdFTPLPVSERootDir=FTPLPVSERootDir
TIdFTPLPVSELibrary=FTPLPVSELibrary
TIdFTPLPVSESubLibrary=FTPLPVSESubLibrary
TIdFTPLPVSEVSAMCatalog=FTPLPVSEVSAMCatalog
TIdFTPLPVSEVTOC=FTPLPVSEVTOC
TIdFTPLPVSEPowerQueue=FTPLPVSEPowerQueue
TIdFTPLPVxWorks=FTPLPVxWorks
TIdFTPLPWindowsNT=FTPLPWindowsNT
TIdFTPLPWinQVNet=FTPLPWinQVNet
TIdFTPLPXecomMicroRTOS=FTPLPXecomMicroRTOS
TIdFTPDirFormat=FTPDirFormat
TIdFTPPathProcessing=FTPPathProcessing
TIdFTPOperation=FTPOperation
TIdMLSDAttr=MLSDAttr
TIdMLSDAttrs=MLSDAttrs
TIdFTPServerContext=FTPServerContext
TIdFTPServer=FTPServer
TIdFTPSecurityOptions=TIdFTPSecurityOptions
TIdDataChannel=FTPDataChannel
TIdTelnetState=TelnetState
TIdFTPUserType=FTPUserType
TIdFTPServerContextBase=FTPServerContextBase
TIdStringStream=StringStream
TIdLocalEvent=LocalEvent
TIdCriticalSection=CriticalSection
TIdPort=Port
TIdIPv6Address=IPv6Address
TIdMaxLineAction=IndyMaxLineAction
TIdOSType=OSType
TIdIPVersion=IndyIPVersion
TIdPID=PID
TIdThreadPriority=ThreadPriority
TIdReuseSocket=ReuseSocket
TIdExtList=ExtList
TIdBaseStream=BaseStream
TIdMimeTable=MIMEList
TIdInterfacedObject=InterfacedObject
TIdWin32Type=TIdWin32Type
TIdGopherMenuItem=GopherMenuItem
TIdGopherMenu=GopherMenu
TIdGopher=Gopher
TIdGopherServer=GopherServer
TIdHash=Hash
TIdHash16=Hash16
TIdHash32=Hash32
TIdHash128=Hash128
TIdHash160=Hash160
TIdHashAdler32=HashAdler32
TIdHashCRC16=HashCRC16
TIdHashCRC32=HashCRC32
TIdHashElf=HashElf
TIdHashMessageDigest=HashMessageDigest
TIdHashMessageDigest2=HashMessageDigest2
TIdHashMessageDigest4=HashMessageDigest4
TIdHashMessageDigest5=HashMessageDigest5
TIdHashSHA1=HashSHA1
TIdHeaderList=HeaderList
TIdHL7Status=HL7Status
TIdHL7=HL7
TIdHL7ClientThread=HL7ClientThread
TIdHostNameServer=HostNameServer
TIdHTTPMethod=HTTPMethod
TIdHTTPWhatsNext=HTTPWhatsNext
TIdHTTPConnectionType=HTTPConnectionType
TIdHTTPOption=HTTPOption
TIdHTTPOptions=HTTPOptions
TIdHTTPProtocolVersion=HTTPProtocolVersion
TIdCustomHTTP=CustomHTTP
TIdHTTPResponse=HTTPResponse
TIdHTTPRequest=HTTPRequest
TIdHTTPProtocol=HTTPProtocol
TIdHTTP=HTTP
TIdEntityHeaderInfo=EntityHeaderInfo
TIdProxyConnectionInfo=ProxyConnectionInfo
TIdRequestHeaderInfo=RequestHeaderInfo
TIdResponseHeaderInfo=ResponseHeaderInfo
TIdHTTPProxyServerThread=HTTPProxyServerThread
TIdHTTPProxyServer=HTTPProxyServer
TIdHTTPServer=HTTPServer
TIdHTTPAppRequest=HTTPAppRequest
TIdHTTPAppResponse=HTTPAppResponse
TIdHTTPWebBrokerBridge=HTTPWebBrokerBridge
TIdIcmpClient=IcmpClient
TIdIdent=Ident
TIdIMAP4FolderTreatment=IMAP4FolderTreatment
TIdIMAP4AuthenticationType=IMAP4AuthenticationType
TIdImapSubSection=ImapSubSection
TIdImapMessagePart=ImapMessagePart
TIdImapMessageParts=ImapMessageParts
TIdIMAPLineStruct=IMAPLineStruct
TIdIMAP4Commands=IMAP4CommandList
TIdIMAP4ConnectionState=IMAP4ConnectionState
TIdIMAP4SearchKey=IMAP4SearchKey
TIdIMAP4SearchKeyArray=IMAP4SearchKeyArray
TIdIMAP4SearchRec=IMAP4SearchRec
TIdIMAP4SearchRecArray=IMAP4SearchRecArray
TIdIMAP4StatusDataItem=TIdIMAP4StatusDataItem
TIdIMAP4StoreDataItem=TIdIMAP4StoreDataItem
TIdRetrieveOnSelect=RetrieveOnSelect
TIdIMAP4=IMAP4
TIdIMAP4Tag=IMAP4Tag
TIdIMAP4PeerContext=IMAP4PeerContext
TIdIMAP4Server=IMAP4Server
TIdConnectionIntercept=ConnectionIntercept
TIdServerIntercept=ServerIntercept
TIdInterceptSimLog=InterceptSimLog
TIdInterceptThrottler=InterceptThrottler
TIdIOHandlerClass=IOHandlerClass
TIdIOHandler=IOStream
TIdIOHandlerSocket=IOHandlerSocket
TIdIOHandlerStack=IOHandlerStack
TIdIOHandlerStream=IOHandlerStream
TIdIOHandlerStreamType=IOHandlerStreamType
TIdIPAddress=IPAddress
TIdIPAddrMonEvent=IPAddrMonEvent
TIdIPAddrMonThread=IPAddrMonThread
TIdIPAddrMon=IPAddrMon
TIdIPMCastBase=IPMCastBase
TIdIPMCastClient=IPMCastClient
TIdIPMCastListenerThread=IPMCastListenerThread
TIdIPMCastServer=IPMCastServer
TIdIPWatchThread=IPWatchThread
TIdIPWatch=IPWatch
TIdIRC=IRC
TIdIRCUserMode=IRCUserMode
TIdIRCUserModes=IRCUserModes
TIdIRCStat=IRCStat
TIdIRCReplies=IRCReplies
TIdIRCServer=IRCServer
TIdLogBase=LogBase
TIdLogDebugTarget=LogDebugTarget
TIdLogDebug=LogDebug
TIdLogEvent=LogEvent
TIdLogFile=LogFile
TIdLogStream=LogStream
TIdLPRFileFormat=LPRFileFormat
TIdLPRControlFile=LPRControlFile
TIdLPRStatus=LPRStatus
TIdLPR=LPR
TIdMailBoxState=MailBoxState
TIdMailBoxAttributes=MailBoxAttribs
TIdMailBoxAttributesSet=MailBoxAttributesSet
TIdMailBox=IMAP4Mailbox
TIdMappedFtpDataThread=MappedFtpDataThread
TIdMappedFtpContext=MappedFtpContext
TIdMappedFtpOutboundDcMode=MappedFtpOutboundDcMode
TIdMappedFTP=MappedFTP
TIdMappedPOP3Thread=MappedPOP3Thread
TIdMappedPOP3=MappedPOP3
TIdMappedPortTCP=MappedPortTCP
TIdMappedPortContext=MappedPortContext
TIdMappedPortUDP=MappedPortUDP
TIdMappedTelnetThread=MappedTelnetThread
TIdCustomMappedTelnet=CustomMappedTelnet
TIdMappedTelnet=MappedTelnet
TIdMessagePriority=MessagePriority
TIdMIMEBoundary=MIMEBorder
TIdMessageFlags=MsgFlags
TIdMessageFlagsSet=MessageFlagsSet
TIdMessageEncoding=MessageEncoding
TIdMessage=Message
TIdMessageClient=MessageClient
TIdMessageCoderPartType=MessageCoderPartType
TIdMessageDecoder=MessageDecoder
TIdMessageDecoderInfo=MessageDecoderInfo
TIdMessageDecoderList=MessageDecoderList
TIdMessageEncoder=MessageEncoder
TIdMessageEncoderClass=MessageEncoderClass
TIdMessageEncoderInfo=MessageEncoderInfo
TIdMessageEncoderList=MessageEncoderList
TIdMessageDecoderMIME=MessageDecoderMIME
TIdMessageDecoderInfoMIME=MessageDecoderInfoMIME
TIdMessageEncoderMIME=MessageEncoderMIME
TIdMessageEncoderInfoMIME=MessageEncoderInfoMIME
TIdMIMEBoundaryStrings=MIMEBoundaryStrings
TIdMessageEncoderQuotedPrintable=MessageEncoderQuotedPrintable
TIdMessageEncoderInfoQuotedPrintable=MessageEncoderInfoQuotedPrintable
TIdMessageDecoderUUE=MessageDecoderUUE
TIdMessageDecoderInfoUUE=MessageDecoderInfoUUE
TIdMessageEncoderUUEBase=MessageEncoderUUEBase
TIdMessageEncoderUUE=MessageEncoderUUE
TIdMessageEncoderInfoUUE=MessageEncoderInfoUUE
TIdMessageEncoderXXE=MessageEncoderXXE
TIdMessageEncoderInfoXXE=MessageEncoderInfoXXE
TIdMessageDecoderYenc=MessageDecoderYenc
TIdMessageDecoderInfoYenc=MessageDecoderInfoYenc
TIdMessageEncoderYenc=MessageEncoderYenc
TIdMessageEncoderInfoYenc=MessageEncoderInfoYenc
TIdMessageItems=MessageItems
TIdMessageItem=MessageItem
TIdMessageCollection=MessageCollection
TIdMessagePartType=MessagePartType
TIdMessagePart=MessagePart
TIdMessagePartClass=MessagePartClass
TIdMessageParts=MessagePartsList
TIdMultiPartFormDataStream=MultiPartFormDataStream
TIdFormDataField=FormDataField
TIdFormDataFields=FormDataFields
TIdIPAddressType=IPAddressType
TIdNetworkCalculator=NetworkCalculator
TIdModeType=ModeType
TIdNNTPPermission=NNTPPermission
TIdModeSetResult=ModeSetResult
TIdNNTP=NNTP
TIdNNTPContext=NNTPContext
TIdNNTPServer=NNTPServer
TIdValidChars=ValidChars
TIdOTPCalculator=OTPCalculator
TIdPOP3AuthenticationType=POP3AuthenticationType
TIdPOP3=POP3
TIdPOP3ServerState=POP3ServerState
TIdPOP3ServerContext=POP3ServerContext
TIdPOP3Server=POP3Server
TIdQOTD=QOTD
TIdQOTDServer=QOTDServer
TIdQOTDUDP=QOTDUDP
TIdQotdUDPServer=QotdUDPServer
TIdRawBase=RawBase
TIdRawClient=RawClient
TIdSunB=SunB
TIdSunW=SunW
TIdInAddr=InAddr
TIdNetTime=NetTime
TIdICMPEcho=ICMPEcho
TIdICMPFrag=ICMPFrag
TIdICMPTs=ICMPTs
TIdICMPHdr=ICMPHdr
TIdIPOptions=IPOptions
TIdIPHdr=IPHdr
TIdTCPOptions=TCPOptions
TIdTCPHdr=TCPHdr
TIdUDPHdr=UDPHdr
TIdIGMPHdr=IGMPHdr
TIdEtherAddr=EtherAddr
TIdEthernetHdr=EthernetHdr
TIdARPHdr=ARPHdr
TIdDNSHdr=DNSHdr
TIdRIPHdr=RIPHdr
TIdRemoteCMDClient=RemoteCMDClient
TIdRemoteCMDServer=RemoteCMDServer
TIdReplies=Replies
TIdReply=Reply
TIdReplyClass=ReplyClass
TIdRepliesClass=RepliesClass
TIdReplyRFCFormat=ReplyRFCFormat
TIdReplyFTP=ReplyFTP
TIdReplyIMAP4=ReplyIMAP4
TIdReplyPOP3=ReplyPOP3
TIdRepliesRFC=RepliesRFC
TIdReplyRFC=ReplyRFC
TIdSMTPEnhancedCode=SMTPEnhancedCode
TIdReplySMTP=ReplySMTP
TIdRexec=Rexec
TIdRexecServer=RexecServer
TIdRSH=RSH
TIdRSHServer=RSHServer
TIdSASLResult=SASLResult
TIdSASLServiceName=SASLServiceName
TIdSASL=SASL
TIdSASLAnonymous=SASLAnonymous
TIdSASLListEntry=SASLListEntry
TIdSASLEntries=SASLEntries
TIdSASLExternal=SASLExternal
TIdSASLLogin=SASLLogin
TIdSASLOTP=SASLOTP
TIdSASLPlain=SASLPlain
TIdSASLSKey=SASLSKey
TIdSASLUserPass=SASLUserPass
TIdSASLCRAMMD5=SASLCRAMMD5
TIdScheduler=SchedulerBase
TIdYarnOfThread=YarnOfThread
TIdSchedulerOfThread=SchedulerOfThread
TIdSchedulerOfThreadDefault=SchedulerOfThreadDefault
TIdSchedulerOfThreadPool=SchedulerOfThreadPool
TIdServerInterceptLogBase=ServerInterceptLogBase
TIdServerInterceptLogFileConnection=ServerInterceptLogFileConnection
TIdServerInterceptLogEvent=ServerInterceptLogEvent
TIdServerInterceptLogFile=ServerInterceptLogFile
TIdServerIOHandler=ServerIOHandler
TIdIOHandlerSocketClass=IOHandlerSocketClass
TIdServerIOHandlerSocket=ServerIOHandlerSocket
TIdServerIOHandlerSSLOpenSSL=ServerIOHandlerSSLOpenSSL
TIdServerIOHandlerStack=ServerIOHandlerStack
TIdSimpleServer=SimpleServer
TIdSMTPAuthenticationType=SMTPAuthenticationType
TIdSMTP=SMTP
TIdSMTPBase=SMTPBase
TIdSMTPRelayStatusAction=SMTPRelayStatusAction
TIdSSLSupport=SSLSupport
TIdSMTPRelayStatusItem=SMTPRelayStatusItem
TIdSMTPRelayStatusList=SMTPRelayStatusList
TIdSMTPRelay=SMTPRelay
TIdSSLSupportOptions=SSLSupportOptions
TIdSMTPDataFailure=SMTPDataFailure
TIdSMTPReceiveMode=SMTPReceiveMode
TIdStreamType=StreamType
TIdSMTPGreeting=SMTPGreeting
TIdSMTPRcpReplies=SMTPRcpReplies
TIdSMTPErrorMsgs=SMTPErrorMsgs
TIdSMTPDataReplies=SMTPDataReplies
TIdSMTPMessages=SMTPMessages
TIdSMTPServer=SMTPServer
TIdSMTPState=SMTPState
TIdSMTPServerContext=SMTPServerContext
TIdSNMP=SNMP
TIdSNPP=SNPP
TIdSNTP=SNTP
TIdSocketHandle=SocketHandle
TIdSocketHandles=SocketHandles
TIdSocksInfo=SocksInfo
TIdSocksServerContext=SocksServerContext
TIdCustomSocksServer=CustomSocksServer
TIdSocksServer=SocksServer
TIdEventSocksServer=EventSocksServer
TIdSSHIOHandlerSocketBase=SSHIOHandlerSocketBase
TIdServerIOHandlerSSHBase=ServerIOHandlerSSHBase
TIdClientSSHClass=ClientSSHClass
TIdServerSSHClass=ServerSSHClass
TIdSSHRegEntry=SSHRegEntry
TIdSSHRegistry=SSHRegistry
TIdSSLIOHandlerSocketBase=SSLIOHandlerSocketBase
TIdServerIOHandlerSSLBase=ServerIOHandlerSSLBase
TIdClientSSLClass=ClientSSLClass
TIdServerSSLClass=ServerSSLClass
TIdSSLRegEntry=SSLRegEntry
TIdSSLRegistry=SSLRegistry
TIdX509=X509
TIdSSLVersion=SSLVersion
TIdSSLMode=SSLMode
TIdSSLVerifyMode=SSLVerifyMode
TIdSSLVerifyModeSet=SSLVerifyModeSet
TIdSSLCtxMode=SSLCtxMode
TIdSSLAction=SSLAction
TIdSSLIOHandlerSocketOpenSSL=SSLIOHandlerSocketOpenSSL
TIdSSLCipher=SSLCipher
TIdSSLOptions=SSLOptions
TIdSSLContext=SSLContext
TIdSSLSocket=SSLSocket
TIdX509Name=X509Name
TIdSocketListClass=SocketListClass
TIdSocketList=SocketList
TIdStack=NetworkInterface
TIdStackClass=StackClass
TIdIPv6AddressRec=IPv6AddressRec
TIdIPAddressRec=IPAddressRec
TIdIn4Addr=In4Addr
TIdIn6Addr=In6Addr
TIdStackBSDBase=StackBSDBase
TIdSocketListDotNet=SocketListDotNet
TIdStackDotNet=StackDotNet
TIdSocketListLinux=SocketListLinux
TIdStackLinux=StackLinux
TIdLinger=Linger
TIdSocketListWindows=SocketListWindows
TIdStackWindows=StackWindows
TIdStream=Stream
TIdSync=Sync
TIdNotify=Notify
TIdNotifyMethod=NotifyMethodHandler
TIdSysLog=SysLog
TIdSyslogPRI=SyslogPRI
TIdSysLogMsgPart=SysLogMsgPart
TIdSysLogMessage=SysLogMessage
TIdSyslogServer=SyslogServer
TIdSystat=Systat
TIdSystatServer=SystatServer
TIdSystatUDP=SystatUDP
TIdSystatUDPServer=SystatUDPServer
TIdTask=Task
TIdTCPClientCustom=TCPClientCustom
TIdTCPClient=TCPClient
TIdTCPConnection=TCPConnection
TIdTCPServer=TCPServer
TIdListenerThread=ListenerThread
TIdTCPStream=TCPStream
TIdTelnet=Telnet
TIdTelnetCommand=TelnetCommand
TIdTelnetReadThread=TelnetReadThread
TIdTelnetPeerContext=TelnetPeerContext
TIdTelnetServer=TelnetServer
TIdText=Text
TIdThreadStopMode=ThreadStopMode
TIdThread=Thread
TIdThreadOptions=ThreadOptions
TIdThreadWithTask=ThreadWithTask
TIdThreadClass=ThreadClass
TIdThreadComponent=ThreadComponent
TIdThreadEx=ThreadEx
TIdThreadSafe=ThreadSafe
TIdThreadSafeInteger=ThreadSafeInteger
TIdThreadSafeBoolean=ThreadSafeBoolean
TIdThreadSafeCardinal=ThreadSafeCardinal
TIdThreadSafeString=ThreadSafeString
TIdThreadSafeStringList=ThreadSafeStringList
TIdThreadSafeList=ThreadSafeList
TIdTime=Time
TIdTimeServer=TimeServer
TIdTimeUDP=TimeUDP
TIdTimeUDPServer=TimeUDPServer
TIdTrivialFTP=TrivialFTP
TIdTFTPMode=TFTPMode
TIdTrivialFTPServer=TrivialFTPServer
TIdStatisticsOperation=StatisticsOperation
TIdHeader=Header
TIdTunnelMaster=TunnelMaster
TIdTunnelSlave=TunnelSlave
TIdUDPBase=UDPBase
TIdUDPClient=UDPClient
TIdUDPServer=UDPServer
TIdUDPListenerThread=UDPListenerThread
TIdURIOptionalFields=URIOptionalFields
TIdURIOptionalFieldsSet=URIOptionalFieldsSet
TIdURI=URIParser
TIdUserHandle=UserHandle
TIdUserAccess=UserAccess
TIdCustomUserManagerOption=CustomUserManagerOption
TIdCustomUserManagerOptions=CustomUserManagerOptions
TIdCustomUserManager=CustomUserManager
TIdSimpleUserManager=SimpleUserManager
TIdUserManager=UserManager
TIdUserAccount=UserAccount
TIdUserAccounts=UserAccounts
TIdOTPUserManager=OTPUserManager
TIdOTPUserAccounts=OTPUserAccounts
TIdOTPPassword=OTPPassword
TIdOTPUserAccount=OTPUserAccount
TIdUserPassProvider=UserPassProvider
TIdVCardEmbeddedObject=VCardEmbeddedObject
TIdVCardBusinessInfo=VCardBusinessInfo
TIdVCardGeog=VCardGeog
TIdPhoneAttributes=PhoneAttributes
TIdCardPhoneNumber=CardPhoneNumber
TIdVCardTelephones=VCardTelephones
TIdCardAddressAttributes=CardAddressAttributes
TIdCardAddressItem=CardAddressItem
TIdVCardAddresses=VCardAddresses
TIdVCardMailingLabelItem=VCardMailingLabelItem
TIdVCardMailingLabels=VCardMailingLabels
TIdVCardEMailItem=VCardEMailItem
TIdVCardEMailAddresses=VCardEMailAddresses
TIdVCardName=VCardName
TIdVCard=VCard
TIdWhois=Whois
TIdWhoIsServer=WhoIsServer
TIdYarn=YarnBase
TIdZLibCompressorBase=ZLibCompressorBase
TIdCompressionLevel=CompressionLevel
TIdRepliesIMAP4=RepliesIMAP4
TIdDICTAuthenticationType=DICTAuthenticationType
TIdDICT=DICT
TIdMatch=Match
TIdMatchList=MatchList
TIdGeneric=Generic
TIdStratagy=Stratagy
TIdStratagyList=StratagyList
TIdDBInfo=DBInfo
TIdDBList=DBList
TIdDefinition=Definition
TIdDefinitions=Definitions
TIdThreadSafeDateTime=ThreadSafeDateTime
TIdThreadSafeDouble=ThreadSafeDouble
TIdThreadSafeInt64=ThreadSafeInt64
TIdFTPListOutputItem=FTPListOutputItem
TIdAS400FTPListItem=AS400FTPListItem
TIdFTPLineOwnedList=FTPLineOwnedList
TIdFTPLPGOS8ListItem=FTPLPGOS8ListItem
TIdCiscoIOSFTPListItem=CiscoIOSFTPListItem
TIdDistinctTCPIPFTPListItem=DistinctTCPIPFTPListItem
TIdAEPLFFTPListItem=AEPLFFTPListItem
TIdHellSoftFTPListItem=HellSoftFTPListItem
TIdKA9QFTPListItem=KA9QFTPListItem
TIdMicrowareOS9FTPListItem=MicrowareOS9FTPListItem
TIdMPiXFTPListItem=MPiXFTPListItem
TIdMusicFTPListItem=MusicFTPListItem
TIdMVSFTPListItem=MVSFTPListItem
TIdMVSJESFTPListItem=MVSJESFTPListItem
TIdMVSJESIntF2FTPListItem=MVSJESIntF2FTPListItem
TIdNCSAforDOSFTPListItem=NCSAforDOSFTPListItem
TIdNovellNetwareFTPListItem=NovellNetwareFTPListItem
TIdNovellPSU_DOSFTPListItem=NovellPSU_DOSFTPListItem
TIdNovellPSU_NFSFTPListItem=NovellPSU_NFSFTPListItem
TIdOS2FTPListItem=OS2FTPListItem
TIdSterCommExpOS390FTPListItem=SterCommExpOS390FTPListItem
TIdSterCommEntUxFTPListItem=SterCommEntUxFTPListItem
TIdSterCommEntUxNSFTPListItem=SterCommEntUxNSFTPListItem
TIdSterCommEntUxRootFTPListItem=SterCommEntUxRootFTPListItem
TIdTOPS20FTPListItem=TOPS20FTPListItem
TIdUnixFTPListItem=UnixFTPListItem
TIdUnitreeFTPListItem=UnitreeFTPListItem
TIdVMCMSFTPListItem=VMCMSFTPListItem
TIdVMVirtualReaderFTPListItem=VMVirtualReaderFTPListItem
TIdVMBFSFTPListItem=VMBFSFTPListItem
TIdVMSFTPListItem=VMSFTPListItem
TIdVSERootDirFTPListItem=VSERootDirFTPListItem
TIdVSELibraryFTPListItem=VSELibraryFTPListItem
TIdVSEPowerQueueFTPListItem=VSEPowerQueueFTPListItem
TIdVSESubLibraryFTPListItem=VSESubLibraryFTPListItem
TIdVSEVSAMCatalogFTPListItem=VSEVSAMCatalogFTPListItem
TIdVSEVTOCFTPListItem=VSEVTOCFTPListItem
TIdVxWorksFTPListItem=VxWorksFTPListItem
TIdWindowsNTFTPListItem=WindowsNTFTPListItem
TIdWinQVNetFTPListItem=WinQVNetFTPListItem
TIdXecomMicroRTOSTPListItem=XecomMicroRTOSTPListItem
TIdMinimalFTPListItem=MinimalFTPListItem
TIdRecFTPListItem=RecFTPListItem
TIdMLSTFTPListItem=MLSTFTPListItem
TIdOwnerFTPListItem=OwnerFTPListItem
TIdNovellBaseFTPListItem=NovellBaseFTPListItem
TIdUnixPermFTPListItem=UnixPermFTPListItem
TIdUnixBaseFTPListItem=UnixBaseFTPListItem
TIdMUTF7=MUTF7
TIdIOHandlerStreamMsg=IOHandlerStreamMsg
TIdInt64Parts=Int64Parts
TIdRepliesFTP=RepliesFTP
TIdRepliesPOP3=RepliesPOP3
TIdRepliesSMTP=RepliesSMTP
TIdStreamRandomAccess=StreamRandomAccess
TIdStreamVCLBase=StreamVCLBase
TIdStreamVCLDotNET=StreamVCLDotNET
TIdStreamVCLWin32=StreamVCLWin32
TIdMatchItem=MatchItem
TIdStrategy=Strategy
TIdStrategyList=StrategyList
TIdRR_Error=RR_Error
TIdDNS_ProcessThread=DNS_ProcessThread
TIdTSXPlusFTPListItem=TSXPlusFTPListItem
TIdFTPLPTSXPlus=FTPLPTSXPlus
TIdEncoding=Encoding
TIdBytes=Bytes
TIdMailFromReply=MailFromReply
TIdRCPToReply=RCPToReply
TIdDataReply=DataReply
TIdStrings=IndyStrings
TIdStringList=IndyStringList
TIdCLRStrings=CLRStrings
TIdFSPStatInfo=FSPStatInfo
TIdFSPListItem=FSPListItem
TIdFSPListItems=FSPListItems
TIdFSPDirInfo=FSPDirInfo
TIdFSPPacket=FSPPacket
TIdFSP=FSP
TIdTandemGuardianFTPListItem=TandemGuardianFTPListItem
TIdFTPLPTandemGuardian=FTPLPTandemGuardian
TIdWfFTPFTPListItem=WfFTPFTPListItem
TIdFTPLPWfFTP=FTPLPWfFTP
TIdCoderTNEF=CoderTNEF
TIdCustomTCPServer=CustomTCPServer
TIdFTPLPBaseDOS=FTPLPBaseDOS
TIdChameleonNewtFTPListItem=ChameleonNewtFTPListItem
TIdFTPLPChameleonNewt=FTPLPChameleonNewt
TIdNCSAforMACOSFTPListItem=NCSAforMACOSFTPListItem
TIdFTPLPNCSAforMACOS=FTPLPNCSAforMACOS
TIdPCNFSDFTPListItem=PCNFSDFTPListItem
TIdFTPLPPCNFSD=FTPLPPCNFSD
TIdStratusVOSFTPListItem=StratusVOSFTPListItem
TIdFTPLPStratusVOS=FTPLPStratusVOS
TIdSuperTCPFTPListItem=SuperTCPFTPListItem
TIdFTPLPSuperTCP=FTPLPSuperTCP
TIdUnisysClearPathFTPListItem=UnisysClearPathFTPListItem
TIdFTPLPUnisysClearPath=FTPLPUnisysClearPath
TIdCreationDateFTPListItme=CreationDateFTPListItme
TIdDOSAttributes=DOSAttributes
TIdDOSBaseFTPListItem=DOSBaseFTPListItem
TIdCustomTime=CustomTime
TIdCustomTimeServer=CustomTimeServer
TIdCustomTimeUDP=CustomTimeUDP
TIdCustomTimeUDPServer=CustomTimeUDPServer
TIdUnixTime=UnixTime
TIdUnixTimeServer=UnixTimeServer
TIdUnixTimeUDP=UnixTimeUDP
TIdUnixTimeUDPServer=UnixTimeUDPServer
